XXXXXXXUXX
X        X
X X X XXXX
X XXX    X
X    XXXXX
XXXX X   X
X    X X X
XX XXXXX X
X        X
XXXXEXXXXX